1111111111111
1000000C00001
1001111111001
1CE001PC00001       
1111111111111